"filename", "language", "C++", "C", "comment", "blank", "total"
"c:\Users\CamGH\OneDrive - Southern Alberta Institute of Technology\Physics Simulations\Flywheel Simulation\src\definitions\color.h", "C", 0, 10, 0, 2, 12
"c:\Users\CamGH\OneDrive - Southern Alberta Institute of Technology\Physics Simulations\Flywheel Simulation\src\definitions\dimensions.h", "C", 0, 5, 0, 1, 6
"c:\Users\CamGH\OneDrive - Southern Alberta Institute of Technology\Physics Simulations\Flywheel Simulation\src\definitions\units.h", "C", 0, 3, 0, 1, 4
"c:\Users\CamGH\OneDrive - Southern Alberta Institute of Technology\Physics Simulations\Flywheel Simulation\src\graphics\graphics.c", "C", 0, 139, 0, 38, 177
"c:\Users\CamGH\OneDrive - Southern Alberta Institute of Technology\Physics Simulations\Flywheel Simulation\src\graphics\graphics.h", "C", 0, 21, 0, 6, 27
"c:\Users\CamGH\OneDrive - Southern Alberta Institute of Technology\Physics Simulations\Flywheel Simulation\src\graphics\keyframe.c", "C", 0, 11, 1, 2, 14
"c:\Users\CamGH\OneDrive - Southern Alberta Institute of Technology\Physics Simulations\Flywheel Simulation\src\graphics\keyframe.h", "C++", 9, 0, 0, 2, 11
"c:\Users\CamGH\OneDrive - Southern Alberta Institute of Technology\Physics Simulations\Flywheel Simulation\src\graphics\renderer.c", "C", 0, 20, 0, 2, 22
"c:\Users\CamGH\OneDrive - Southern Alberta Institute of Technology\Physics Simulations\Flywheel Simulation\src\graphics\renderer.h", "C", 0, 5, 0, 1, 6
"c:\Users\CamGH\OneDrive - Southern Alberta Institute of Technology\Physics Simulations\Flywheel Simulation\src\physics\physics.c", "C", 0, 37, 0, 6, 43
"c:\Users\CamGH\OneDrive - Southern Alberta Institute of Technology\Physics Simulations\Flywheel Simulation\src\physics\physics.h", "C", 0, 39, 0, 9, 48
"c:\Users\CamGH\OneDrive - Southern Alberta Institute of Technology\Physics Simulations\Flywheel Simulation\src\simulation\ball.c", "C", 0, 98, 3, 25, 126
"c:\Users\CamGH\OneDrive - Southern Alberta Institute of Technology\Physics Simulations\Flywheel Simulation\src\simulation\ball.h", "C++", 10, 0, 0, 2, 12
"c:\Users\CamGH\OneDrive - Southern Alberta Institute of Technology\Physics Simulations\Flywheel Simulation\src\simulation\controller.c", "C", 0, 63, 0, 13, 76
"c:\Users\CamGH\OneDrive - Southern Alberta Institute of Technology\Physics Simulations\Flywheel Simulation\src\simulation\controller.h", "C++", 5, 0, 0, 1, 6
"c:\Users\CamGH\OneDrive - Southern Alberta Institute of Technology\Physics Simulations\Flywheel Simulation\src\simulation\flywheel.c", "C", 0, 44, 2, 14, 60
"c:\Users\CamGH\OneDrive - Southern Alberta Institute of Technology\Physics Simulations\Flywheel Simulation\src\simulation\flywheel.h", "C", 0, 8, 0, 2, 10
"c:\Users\CamGH\OneDrive - Southern Alberta Institute of Technology\Physics Simulations\Flywheel Simulation\src\simulation\simulation.c", "C", 0, 48, 0, 15, 63
"c:\Users\CamGH\OneDrive - Southern Alberta Institute of Technology\Physics Simulations\Flywheel Simulation\src\simulation\telemetry.c", "C", 0, 86, 1, 23, 110
"c:\Users\CamGH\OneDrive - Southern Alberta Institute of Technology\Physics Simulations\Flywheel Simulation\src\simulation\telemetry.h", "C++", 3, 0, 0, 1, 4
"c:\Users\CamGH\OneDrive - Southern Alberta Institute of Technology\Physics Simulations\Flywheel Simulation\src\system\events.c", "C", 0, 28, 0, 5, 33
"c:\Users\CamGH\OneDrive - Southern Alberta Institute of Technology\Physics Simulations\Flywheel Simulation\src\system\events.h", "C", 0, 4, 0, 1, 5
"c:\Users\CamGH\OneDrive - Southern Alberta Institute of Technology\Physics Simulations\Flywheel Simulation\src\system\input.c", "C", 0, 41, 1, 11, 53
"c:\Users\CamGH\OneDrive - Southern Alberta Institute of Technology\Physics Simulations\Flywheel Simulation\src\system\input.h", "C", 0, 9, 0, 2, 11
"c:\Users\CamGH\OneDrive - Southern Alberta Institute of Technology\Physics Simulations\Flywheel Simulation\src\system\timer.c", "C", 0, 26, 0, 5, 31
"c:\Users\CamGH\OneDrive - Southern Alberta Institute of Technology\Physics Simulations\Flywheel Simulation\src\system\timer.h", "C", 0, 4, 0, 1, 5
"Total", "-", 27, 749, 8, 191, 975