"filename", "language", "C", "C++", "comment", "blank", "total"
"c:\Users\CamGH\OneDrive - Southern Alberta Institute of Technology\Physics Simulations\Flywheel Simulation\src\definitions\dimensions.h", "C", 1, 0, 0, 0, 1
"c:\Users\CamGH\OneDrive - Southern Alberta Institute of Technology\Physics Simulations\Flywheel Simulation\src\graphics\graphics.c", "C", 9, 0, 0, 3, 12
"c:\Users\CamGH\OneDrive - Southern Alberta Institute of Technology\Physics Simulations\Flywheel Simulation\src\graphics\graphics.h", "C", 3, 0, 0, 1, 4
"c:\Users\CamGH\OneDrive - Southern Alberta Institute of Technology\Physics Simulations\Flywheel Simulation\src\physics\physics.c", "C", 6, 0, 0, 1, 7
"c:\Users\CamGH\OneDrive - Southern Alberta Institute of Technology\Physics Simulations\Flywheel Simulation\src\physics\physics.h", "C", 3, 0, 0, 0, 3
"c:\Users\CamGH\OneDrive - Southern Alberta Institute of Technology\Physics Simulations\Flywheel Simulation\src\simulation\ball.c", "C", 12, 0, -2, 3, 13
"c:\Users\CamGH\OneDrive - Southern Alberta Institute of Technology\Physics Simulations\Flywheel Simulation\src\simulation\ball.h", "C++", 0, 3, 0, 1, 4
"c:\Users\CamGH\OneDrive - Southern Alberta Institute of Technology\Physics Simulations\Flywheel Simulation\src\simulation\controller.c", "C", 37, 0, 0, 5, 42
"c:\Users\CamGH\OneDrive - Southern Alberta Institute of Technology\Physics Simulations\Flywheel Simulation\src\simulation\controller.h", "C++", 0, 2, 0, 0, 2
"c:\Users\CamGH\OneDrive - Southern Alberta Institute of Technology\Physics Simulations\Flywheel Simulation\src\simulation\flywheel.c", "C", 5, 0, 0, 1, 6
"c:\Users\CamGH\OneDrive - Southern Alberta Institute of Technology\Physics Simulations\Flywheel Simulation\src\simulation\flywheel.h", "C", 1, 0, 0, 1, 2
"c:\Users\CamGH\OneDrive - Southern Alberta Institute of Technology\Physics Simulations\Flywheel Simulation\src\simulation\simulation.c", "C", 2, 0, 0, 1, 3
"c:\Users\CamGH\OneDrive - Southern Alberta Institute of Technology\Physics Simulations\Flywheel Simulation\src\simulation\telemetry.c", "C", 60, 0, 1, 15, 76
"c:\Users\CamGH\OneDrive - Southern Alberta Institute of Technology\Physics Simulations\Flywheel Simulation\src\simulation\telemetry.h", "C++", 0, 1, 0, 0, 1
"c:\Users\CamGH\OneDrive - Southern Alberta Institute of Technology\Physics Simulations\Flywheel Simulation\src\system\input.c", "C", 10, 0, 1, 2, 13
"c:\Users\CamGH\OneDrive - Southern Alberta Institute of Technology\Physics Simulations\Flywheel Simulation\src\system\input.h", "C", 2, 0, 0, 0, 2
"c:\Users\CamGH\OneDrive - Southern Alberta Institute of Technology\Physics Simulations\Flywheel Simulation\src\system\timer.c", "C", 2, 0, 0, 1, 3
"Total", "-", 153, 6, 0, 35, 194